#.....................
#.....................
#......#..............
#......#..............
#......#..............
#......#..............
#.....................
#.....................
#.......@.............
#.....................
#.....................
#.....................
#.....................
#.....................
#.........#...........
#.........#...........
#.........#...........
#.........b...........
#.....................
#.....................
#.....................
#.....................
