#.....................
#.....................
#......#..............
#......#..............
#......#..............
#......#..............
#.......@.............
#.....................
#.....................
#.....................
#.....................
#.....................
#.....................
#.....................
#.....................
#.....................
#.....................
#.....................
#.....................
#.....................
#.....................
#.....................
